width 10
height 10

1 0 0 0 2 0 0 0 0 0 
0 0 4 3 0 0 0 2 0 0 
0 0 0 0 0 0 0 2 0 0 
0 0 0 0 0 0 0 2 0 0 
0 0 0 0 0 0 0 2 0 0 
0 0 0 0 0 0 0 2 0 0 
0 0 0 0 0 0 0 2 0 0 
0 0 0 0 0 0 0 2 0 0 
0 0 0 0 0 0 0 2 0 0 
0 0 0 0 0 0 0 2 0 0 
