Width: 10
Height: 10

1 0 2 2 2 2 2 2 2 0 
2 0 2 2 2 2 2 2 2 0 
2 2 2 2 2 2 2 2 2 2 
2 2 2 0 2 2 2 2 2 2 
2 2 2 2 0 2 2 2 2 2 
2 2 2 2 2 0 2 2 2 2 
2 2 2 2 2 2 2 2 2 2 
2 2 2 2 2 2 2 2 2 0 
2 2 2 2 2 2 2 2 0 2 
2 2 2 2 0 2 2 2 0 0 
