Width: 10
Height: 10

0 2 2 2 0 2 0 2 2 2 
2 2 2 2 2 2 2 2 2 0 
2 2 2 2 2 2 2 2 2 2 
2 2 2 2 2 2 2 2 2 2 
0 2 2 2 2 2 2 2 2 2 
2 2 2 2 2 2 2 2 2 2 
2 2 2 2 2 2 0 2 2 2 
2 2 2 2 2 2 2 2 2 0 
2 2 2 2 2 2 2 2 1 2 
2 2 2 2 2 2 2 2 0 0 
